Date,Type,Description,Amount,Balance,Tags
03 Dec 23,Credit,GOOGLEINDI / IMPS,90.0,11873.83,other_income
04 Dec 23,Debit,AIRTEL/PYTM/PAYAIR,266.1,11607.73,mobile_recharge
05 Dec 23,Credit,GOOGLEINDI / IMPS,1810.0,13417.73,other_income
05 Dec 23,Credit,BUNDL TECHNOLOGI,8875.61,22293.34,business_income
05 Dec 23,Credit,BUNDL TECHNOLOGI,1698.7,23992.04,business_income
05 Dec 23,Debit,BHARAT P/PYTM/PAYTM,4205.0,19787.04,miscellaneous_expense
05 Dec 23,Debit,L SURESH/HDFC/STARSURESH,14000.0,5787.04,miscellaneous_expense
05 Dec 23,Debit,DRADHIKA/CIUB/DRADHIKARA,3000.0,2787.04,miscellaneous_expense
06 Dec 23,Credit,GOOGLEINDI / IMPS,3550.0,6337.04,other_income
06 Dec 23,Debit,ADD MONE/PYTM/ADD-MONEY,1000.0,5337.04,miscellaneous_expense
06 Dec 23,Credit,ZOMATO LIMITED,15483.66,20820.7,business_income
06 Dec 23,Debit,EURONETG/ICIC/EURONETGPA,3226.9,17593.8,miscellaneous_expense
07 Dec 23,Credit,GOOGLEINDI / IMPS,120.0,17713.8,other_income
07 Dec 23,Credit,BUNDL TECHNOLOGI,858.11,18571.91,business_income
07 Dec 23,Credit,BUNDL TECHNOLOGI,5942.57,24514.48,business_income
08 Dec 23,Debit,MR KUMAR/IDIB/KUMARESAN,4360.0,20154.48,miscellaneous_expense
08 Dec 23,Debit,KARTHICK/IDFB/KARTHICKO,1026.0,19128.48,miscellaneous_expense
08 Dec 23,Debit,HALWA KA/PYTM/PAYTMQR88T,330.0,18798.48,miscellaneous_expense
09 Dec 23,Debit,ASIAN PL/ICIC/GPAY-11217,4030.0,14768.48,miscellaneous_expense
09 Dec 23,Debit,ASALDAS /KKBK/9884651814,4830.0,9938.48,miscellaneous_expense
11 Dec 23,Credit,GOOGLEINDI / IMPS,294.0,10232.48,other_income
11 Dec 23,Debit,MR A BEN/IDIB/BENEDICT A,1000.0,9232.48,miscellaneous_expense
11 Dec 23,Debit,NAVEENKU/HDFC/NAVEENKUMA,6250.0,2982.48,miscellaneous_expense
12 Dec 23,Credit,BUNDL TECHNOLOGI,2166.66,5149.14,business_income
12 Dec 23,Credit,BUNDL TECHNOLOGI,1899.07,7048.21,business_income
13 Dec 23,Debit,ADD MONE/PYTM/ADD-MONEY,1000.0,6048.21,miscellaneous_expense
13 Dec 23,Debit,AV TRADE/UTIB/9786199468,1800.0,4248.21,miscellaneous_expense
13 Dec 23,Credit,ZOMATO LIMITED,6151.23,10399.44,business_income
13 Dec 23,Credit,GOOGLEINDI / IMPS,620.0,11019.44,other_income
14 Dec 23,Credit,BUNDL TECHNOLOGI,4018.56,15038.0,business_income
14 Dec 23,Credit,BUNDL TECHNOLOGI,1541.07,16579.07,business_income
15 Dec 23,Credit,GOOGLEINDI / IMPS,1193.0,17772.07,other_income
16 Dec 23,Credit,GOOGLEINDI / IMPS,1442.0,19214.07,other_income
16 Dec 23,Debit,10002312/IBKL/1000231212,7120.0,12094.07,miscellaneous_expense
16 Dec 23,Debit,R HARUN /PYTM/PAYTMQR1BI,920.0,11174.07,miscellaneous_expense
16 Dec 23,Debit,PANDIYAN/PYTM/PAYTMQR6LO,2600.0,8574.07,miscellaneous_expense
16 Dec 23,Debit,SRI SAI /PYTM/PAYTM-8039,90.0,8484.07,miscellaneous_expense
16 Dec 23,Credit,GOOGLEINDI / IMPS,1265.0,9749.07,other_income
17 Dec 23,Credit,GOOGLEINDI / IMPS,1954.0,11703.07,other_income
19 Dec 23,Credit,GOOGLEINDI / IMPS,1125.0,12828.07,other_income
19 Dec 23,Credit,BUNDL TECHNOLOGI,5170.03,17998.1,business_income
19 Dec 23,Credit,BUNDL TECHNOLOGI,2246.09,20244.19,business_income
19 Dec 23,Debit,DHAKSHAN/KKBK/DHAKSHANCH,3900.0,16344.19,miscellaneous_expense
19 Dec 23,Debit,DUMMY NA/IDIB/7569291139,4200.0,12144.19,miscellaneous_expense
20 Dec 23,Credit,GOOGLEINDI / IMPS,1196.0,13340.19,other_income
20 Dec 23,Debit,ADD MONE/PYTM/ADD-MONEY,1000.0,12340.19,miscellaneous_expense
20 Dec 23,Credit,ZOMATO LIMITED,12661.98,25002.17,business_income
21 Dec 23,Credit,GOOGLEINDI / IMPS,1356.0,26358.17,other_income
21 Dec 23,Credit,BUNDL TECHNOLOGI,4545.14,30903.31,business_income
21 Dec 23,Credit,BY NEFT TRF: BUNDL TECHNOLOGI,974.1,31877.41,other_income
21 Dec 23,Debit,TO ONL UPI/DR/MUKESH,16240.0,15637.41,p2p_transfer
21 Dec 23,Credit,BY ONL IMPS: GOOGLEINDI,1028.0,16665.41,other_income
23 Dec 23,Credit,BY ONL IMPS: GOOGLEINDI,484.0,17149.41,other_income
23 Dec 23,Debit,TO MONTHLY MAINTENANCE CHARGES,590.0,16559.41,fees_charges
23 Dec 23,Debit,TO ONL UPI/DR/ADD MONE,500.0,16059.41,p2p_transfer
24 Dec 23,Credit,BY ONL IMPS: GOOGLEINDI,826.0,16885.41,other_income
25 Dec 23,Debit,TO ONL UPI/DR/SHAZIA B,930.0,15955.41,p2p_transfer
25 Dec 23,Debit,TO ONL UPI/DR/ASIAN PL,13455.0,2500.41,p2p_transfer
26 Dec 23,Credit,BY NEFT TRF: BUNDL TECHNOLOGI,2299.8,4800.21,other_income
26 Dec 23,Credit,BY NEFT TRF: BUNDL TECHNOLOGI,1653.49,6453.7,other_income
27 Dec 23,Credit,BY NEFT TRF: ZOMATO LIMITED,8247.71,14701.41,other_income
28 Dec 23,Credit,BY ONL IMPS: GOOGLEINDI,887.0,15588.41,other_income
28 Dec 23,Credit,BY NEFT TRF: BUNDL TECHNOLOGI,1140.17,16728.58,other_income
28 Dec 23,Credit,BY NEFT TRF: BUNDL TECHNOLOGI,3948.3,20676.88,other_income
29 Dec 23,Debit,TO ONL UPI/DR/ADD MONE,1000.0,19676.88,p2p_transfer
30 Dec 23,Debit,TO ONL UPI/DR/MURUGAN,500.0,19176.88,p2p_transfer
30 Dec 23,Debit,TO ONL UPI/DR/SARATH E,700.0,18476.88,p2p_transfer
31 Dec 23,Debit,TO ONL UPI/DR/PRIYANKA,500.0,17976.88,p2p_transfer
31 Dec 23,Debit,TO ONL UPI/DR/KOMATHIR,1000.0,16976.88,p2p_transfer
31 Dec 23,Debit,TO ONL UPI/DR/AXIS BAN,1180.0,15796.88,p2p_transfer
01 Jan 24,Credit,BY ONL IMPS: GOOGLEINDI,242.0,16038.88,other_income
02 Jan 24,Debit,TO ONL UPI/DR/SUBHASHI,1019.0,15019.88,p2p_transfer
02 Jan 24,Debit,TO POS: TASMAC SHOP NO 4466 CHENNAI,2300.0,12719.88,shopping
02 Jan 24,Debit,TO ONL UPI/DR/IBIBO GR,945.0,11774.88,p2p_transfer
02 Jan 24,Debit,TO ONL UPI/DR/ABDUL AZ,10000.0,1774.88,p2p_transfer
03 Jan 24,Credit,BY NEFT TRF: BUNDL TECHNOLOGI,1990.72,3765.6,other_income
03 Jan 24,Credit,BY NEFT TRF: BUNDL TECHNOLOGI,4881.18,8646.78,other_income
03 Jan 24,Credit,BY NEFT TRF: ZOMATO LIMITED,10502.55,19149.33,other_income
03 Jan 24,Debit,TO ONL UPI/DR/APOLLO P,639.0,18510.33,healthcare_pharmacy
03 Jan 24,Credit,BY ONL IMPS: GOOGLEINDI,110.0,18620.33,other_income
04 Jan 24,Debit,TO ONL UPI/DR/SSHARMIL,340.0,18280.33,p2p_transfer
05 Jan 24,Debit,TO ONL UPI/DR/BALAJI T,7410.0,10870.33,p2p_transfer
05 Jan 24,Credit,BY NEFT TRF: BUNDL TECHNOLOGI,2624.63,13494.96,other_income
05 Jan 24,Credit,BY NEFT TRF: BUNDL TECHNOLOGI,738.92,14233.88,other_income
05 Jan 24,Debit,TO ONL UPI/DR/ZEE ENTE,710.0,13523.88,subscription
06 Jan 24,Debit,TO ONL UPI/DR/SATHISHK,2550.0,10973.88,p2p_transfer
06 Jan 24,Debit,TO ONL UPI/DR/KALLAVAN,5000.0,5973.88,p2p_transfer
06 Jan 24,Debit,TO ONL UPI/DR/VIDHU SU,299.0,5674.88,p2p_transfer
07 Jan 24,Credit,BY ONL IMPS: GOOGLEINDI,142.0,5816.88,other_income
07 Jan 24,Debit,TO ONL UPI/DR/SELVAMR2,2000.0,3816.88,p2p_transfer
09 Jan 24,Debit,TO ONL UPI/DR/ADD MONE,1000.0,2816.88,p2p_transfer
09 Jan 24,Credit,BY NEFT TRF: BUNDL TECHNOLOGI,4470.62,7287.5,other_income
09 Jan 24,Credit,BY NEFT TRF: BUNDL TECHNOLOGI,1199.67,8487.17,other_income
10 Jan 24,Credit,BY NEFT TRF: ZOMATO LIMITED,11743.07,20230.24,other_income
10 Jan 24,Debit,TO ONL UPI/DR/AV TRADE,4400.0,15830.24,p2p_transfer
11 Jan 24,Debit,TO ONL UPI/DR/VIJESH P,200.0,15630.24,p2p_transfer
12 Jan 24,Debit,TO ONL UPI/DR/SHARMILN,1450.0,14180.24,p2p_transfer
12 Jan 24,Credit,BY NEFT TRF: BUNDL TECHNOLOGI,887.28,15067.52,other_income
12 Jan 24,Credit,BY NEFT TRF: BUNDL TECHNOLOGI,4878.15,19945.67,other_income
12 Jan 24,Credit,BY ATM CASH DEPOSIT- CARDLESS,30000.0,49945.67,cash_deposit
12 Jan 24,Debit,TO ONL UPI/DR/NAGALING,30000.0,19945.67,p2p_transfer
14 Jan 24,Credit,BY ONL IMPS: GOOGLEINDI,1650.0,21595.67,other_income
16 Jan 24,Debit,TO ONL UPI/DR/ABDUL AZ,11700.0,9895.67,p2p_transfer
16 Jan 24,Debit,TO ONL UPI/DR/PARTHIPA,4180.0,5715.67,p2p_transfer
16 Jan 24,Credit,BY NEFT TRF: BUNDL TECHNOLOGI,2293.41,8009.08,other_income
16 Jan 24,Credit,BY NEFT TRF: BUNDL TECHNOLOGI,4697.71,12706.79,other_income
16 Jan 24,Debit,TO ONL UPI/DR/DUMMY NA,12000.0,706.79,p2p_transfer
17 Jan 24,Credit,BY NEFT TRF: ZOMATO LIMITED,16697.15,17403.94,other_income
17 Jan 24,Debit,TO ONL UPI/DR/IBIBO GR,2412.9,14991.04,p2p_transfer
17 Jan 24,Debit,TO ONL UPI/DR/ALAGURAJ,940.0,14051.04,p2p_transfer
17 Jan 24,Credit,BY ONL IMPS: HOTEL JAIH,3000.0,17051.04,other_income
17 Jan 24,Debit,TO ONL UPI/DR/EURONETG,14620.0,2431.04,p2p_transfer
18 Jan 24,Credit,BY ONL IMPS: GOOGLEINDI,300.0,2731.04,other_income
18 Jan 24,Credit,BY NEFT TRF: BUNDL TECHNOLOGI,989.85,3720.89,other_income
18 Jan 24,Credit,BY NEFT TRF: BUNDL TECHNOLOGI,4793.05,8513.94,other_income
19 Jan 24,Credit,BY ONL IMPS: GOOGLEINDI,672.0,9185.94,other_income
19 Jan 24,Debit,TO ONL UPI/DR/ADD MONE,835.8,8350.14,p2p_transfer
19 Jan 24,Debit,TO ONL UPI/DR/PANDIESH,3500.0,4850.14,p2p_transfer
20 Jan 24,Credit,BY ONL IMPS: GOOGLEINDI,551.0,5401.14,other_income
20 Jan 24,Debit,UPI/SEED2PLANT,147.0,5254.14,miscellaneous_expense
20 Jan 24,Debit,UPI/ADD-MONEY@,1000.0,4254.14,miscellaneous_expense
20 Jan 24,Debit,UPI/R B STOR,2125.0,2129.14,miscellaneous_expense
23 Jan 24,Credit,NEFT/BUNDL TECHNOLOGI,2334.6,4463.74,other_income
23 Jan 24,Credit,NEFT/BUNDL TECHNOLOGI,5467.7,9931.44,other_income
23 Jan 24,Debit,UPI/ANJALAI,2694.0,7237.44,miscellaneous_expense
24 Jan 24,Credit,IMPS/GOOGLEINDI,310.0,7547.44,other_income
24 Jan 24,Credit,NEFT/ZOMATO LIMITED,15176.45,22723.89,other_income
25 Jan 24,Credit,NEFT/BUNDL TECHNOLOGI,1224.93,23948.82,other_income
25 Jan 24,Credit,NEFT/BUNDL TECHNOLOGI,6061.64,30010.46,other_income
26 Jan 24,Credit,IMPS/GOOGLEINDI,200.0,30210.46,other_income
26 Jan 24,Debit,MONTHLY MAINTENANCE CHARGES,590.0,29620.46,fees_charges
26 Jan 24,Debit,SMS CHARGES,33.0,29587.46,fees_charges
26 Jan 24,Debit,UPI/THIYAGHA,25000.0,4587.46,miscellaneous_expense
26 Jan 24,Credit,IMPS/GOOGLEINDI,350.0,4937.46,other_income
27 Jan 24,Debit,POS/TASMAC SHOP,2220.0,2717.46,entertainment_dining_out
28 Jan 24,Credit,IMPS/GOOGLEINDI,200.0,2917.46,other_income
30 Jan 24,Debit,UPI/ADD-MONEY@,1000.0,1917.46,miscellaneous_expense
30 Jan 24,Credit,NEFT/BUNDL TECHNOLOGI,6567.52,8484.98,other_income
30 Jan 24,Credit,NEFT/BUNDL TECHNOLOGI,2557.08,11042.06,other_income
30 Jan 24,Credit,IMPS/GOOGLEINDI,500.0,11542.06,other_income
31 Jan 24,Debit,UPI/PRAKASHP,95.0,11447.06,miscellaneous_expense
31 Jan 24,Debit,UPI/SIVA SHA,105.0,11342.06,miscellaneous_expense
31 Jan 24,Credit,NEFT/ZOMATO LIMITED,14424.29,25766.35,other_income
01 Feb 24,Debit,UPI/BAKIYARA,200.0,25566.35,miscellaneous_expense
02 Feb 24,Debit,UPI/BALAJI N,20000.0,5566.35,miscellaneous_expense
02 Feb 24,Debit,UPI/PUMP 1 K,1000.0,4566.35,fuel
03 Feb 24,Credit,NEFT/BUNDL TECHNOLOGI,697.55,5263.9,other_income
03 Feb 24,Credit,NEFT/BUNDL TECHNOLOGI,5575.59,10839.49,other_income
04 Feb 24,Debit,UPI/DEEPADEE,2000.0,8839.49,miscellaneous_expense
04 Feb 24,Debit,UPI/POTHYS P,6255.0,2584.49,shopping
05 Feb 24,Credit,IMPS/HOTEL JAIH,4000.0,6584.49,other_income
07 Feb 24,Debit,UPI/JIO,300.1,6284.39,mobile_recharge
07 Feb 24,Credit,NEFT/ZOMATO LIMITED,13043.5,19327.89,other_income
07 Feb 24,Credit,NEFT/BUNDL TECHNOLOGI,923.28,20251.17,other_income
07 Feb 24,Credit,NEFT/BUNDL TECHNOLOGI,4754.84,25006.01,other_income
07 Feb 24,Debit,UPI/THIYAGHA,20000.0,5006.01,miscellaneous_expense
08 Feb 24,Debit,UPI/ASWINS H,655.0,4351.01,miscellaneous_expense
08 Feb 24,Debit,UPI/ASWINS H,2750.0,1601.01,miscellaneous_expense
09 Feb 24,Credit,NEFT/BUNDL TECHNOLOGI,3831.53,5432.54,other_income
09 Feb 24,Credit,NEFT/BUNDL TECHNOLOGI,955.51,6388.05,other_income
11 Feb 24,Debit,UPI/ADD-MONEY@,1000.0,5388.05,miscellaneous_expense
11 Feb 24,Debit,UPI/PARTHIPA,3800.0,1588.05,miscellaneous_expense
11 Feb 24,Debit,UPI/ANBARASA,500.0,1088.05,miscellaneous_expense
12 Feb 24,Debit,UPI/LABURAM,190.0,898.05,miscellaneous_expense
12 Feb 24,Debit,UPI/SIMPLCHE,400.0,498.05,miscellaneous_expense
13 Feb 24,Credit,NEFT/BUNDL TECHNOLOGI,7186.12,7684.17,other_income
13 Feb 24,Credit,NEFT/BUNDL TECHNOLOGI,2228.77,9912.94,other_income
13 Feb 24,Debit,UPI/ALAGURAJ,3800.0,6112.94,miscellaneous_expense
14 Feb 24,Debit,UPI/SUNDARIM,800.0,5312.94,miscellaneous_expense
14 Feb 24,Credit,NEFT/ZOMATO LIMITED,15682.39,20995.33,other_income
15 Feb 24,Debit,UPI/ADD-MONEY@,1000.0,19995.33,miscellaneous_expense
15 Feb 24,Credit,NEFT/BUNDL TECHNOLOGI,907.2,20902.53,other_income
15 Feb 24,Credit,NEFT/BUNDL TECHNOLOGI,6172.43,27074.96,other_income
15 Feb 24,Debit,UPI/THIYAGHA,25000.0,2074.96,miscellaneous_expense
17 Feb 24,Debit,UPI/HDFC BAN,1000.0,1074.96,miscellaneous_expense
17 Feb 24,Debit,UPI/MAHENDRA,240.0,834.96,miscellaneous_expense
18 Feb 24,Debit,MONTHLY MAINTENANCE CHARGES,590.0,244.96,fees_charges
20 Feb 24,Credit,NEFT/BUNDL TECHNOLOGI,5087.15,5332.11,other_income
20 Feb 24,Credit,NEFT/BUNDL TECHNOLOGI,1736.57,7068.68,other_income
21 Feb 24,Debit,UPI/ASWINS H,495.0,6573.68,miscellaneous_expense
21 Feb 24,Debit,UPI/JAYALAKS,770.0,5803.68,miscellaneous_expense
21 Feb 24,Debit,UPI/R SYED A,240.0,5563.68,miscellaneous_expense
21 Feb 24,Credit,NEFT/ZOMATO LIMITED,15335.63,20899.31,other_income
22 Feb 24,Debit,UPI/AMMA KAN,300.0,20599.31,miscellaneous_expense
22 Feb 24,Debit,UPI/MR RAJI,1600.0,18999.31,miscellaneous_expense
22 Feb 24,Debit,UPI/MD RAMAZ,1200.0,17799.31,miscellaneous_expense
22 Feb 24,Debit,UPI/SANTHOSH,1300.0,16499.31,miscellaneous_expense
22 Feb 24,Debit,UPI/SHARMILN,1680.0,14819.31,miscellaneous_expense
22 Feb 24,Debit,UPI/SUBRAHMA,5930.0,8889.31,miscellaneous_expense
22 Feb 24,Credit,BY NEFT TRF: BUNDL TECHNOLOGI,288.14,9177.45,other_income
22 Feb 24,Credit,BY NEFT TRF: BUNDL TECHNOLOGI,4253.18,13430.63,other_income
22 Feb 24,Debit,TO ONL UPI/DR/MLAKSHMA,1500.0,11930.63,p2p_transfer
23 Feb 24,Debit,TO ONL UPI/DR/ASWINS H,1460.0,10470.63,p2p_transfer
23 Feb 24,Debit,TO ONL UPI/DR/ASHWIN M,275.0,10195.63,p2p_transfer
23 Feb 24,Debit,TO ONL UPI/DR/APOLLO P,1000.0,9195.63,healthcare_pharmacy
25 Feb 24,Debit,TO ONL UPI/DR/MANNA ME,960.0,8235.63,p2p_transfer
27 Feb 24,Debit,TO POS : HOTEL JAIHIND DHABA,100.0,8135.63,entertainment_dining_out
27 Feb 24,Credit,BY NEFT TRF: BUNDL TECHNOLOGI,8987.52,17123.15,other_income
27 Feb 24,Debit,TO ONL UPI/DR/SARATH E,350.0,16773.15,p2p_transfer
28 Feb 24,Credit,BY NEFT TRF : ZOMATO LIMITED,17501.63,34274.78,other_income
28 Feb 24,Debit,TO ONL UPI/DR/MR BALAJ,6100.0,28174.78,p2p_transfer
29 Feb 24,Debit,TO ONL UPI/DR/R THANGA,26000.0,2174.78,p2p_transfer
05 Mar 24,Credit,BY NEFT TRF: BUNDL TECHNOLOGI,11659.26,13834.04,other_income
06 Mar 24,Debit,TO ONL UPI/DR/VINO3B10,10000.0,3834.04,p2p_transfer
06 Mar 24,Credit,BY NEFT TRF: ZOMATO LIMITED,13981.05,17815.09,other_income
07 Mar 24,Debit,TO ONL UPI/DR/BHUDARAM,600.0,17215.09,p2p_transfer
07 Mar 24,Debit,TO ONL UPI/DR/THENNADU,4725.0,12490.09,p2p_transfer
07 Mar 24,Credit,BY NEFT TRF: BUNDL TECHNOLOGI,9586.18,22076.27,other_income
07 Mar 24,Debit,TO ONL UPI/DR/PURUSHOT,900.0,21176.27,p2p_transfer
08 Mar 24,Debit,TO ONL UPI/DR/P JAYALA,1040.0,20136.27,p2p_transfer
08 Mar 24,Debit,TO ONL UPI/DR/VINO3B10,6354.0,13782.27,p2p_transfer
08 Mar 24,Debit,TO ONL UPI/DR/SRI KRIS,657.0,13125.27,p2p_transfer
08 Mar 24,Debit,TO ONL UPI/DR/72999096,700.0,12425.27,p2p_transfer
10 Mar 24,Debit,TO ONL UPI/DR/MR RAJEN,100.0,12325.27,p2p_transfer
12 Mar 24,Credit,BY NEFT TRF: BUNDL TECHNOLOGI,6281.88,18607.15,other_income
13 Mar 24,Credit,BY NEFT TRF: ZOMATO LIMITED,15368.84,33975.99,other_income
13 Mar 24,Debit,TO ONL UPI/DR/BHARAT P,1129.0,32846.99,p2p_transfer
13 Mar 24,Debit,TO ONL UPI/DR/SIDHEEQ,115.0,32731.99,p2p_transfer
14 Mar 24,Credit,BY NEFT TRF: BUNDL TECHNOLOGI,8500.66,41232.65,other_income
18 Mar 24,Debit,TO ONL UPI/DR/MR RADHA,40000.0,1232.65,p2p_transfer
19 Mar 24,Credit,BY NEFT TRF: BUNDL TECHNOLOGI,7870.42,9103.07,other_income
19 Mar 24,Debit,TO ONL UPI/DR/HOTEL JA,10.0,9093.07,entertainment_dining_out
20 Mar 24,Credit,BY ONL UPI/CR/HOTEL JA,10.0,9103.07,entertainment_dining_out
20 Mar 24,Credit,BY NEFT TRF: ZOMATO LIMITED,9948.94,19052.01,other_income
20 Mar 24,Debit,TO ONL UPI/DR/HOTEL JA,500.0,18552.01,entertainment_dining_out
20 Mar 24,Debit,TO ONL UPI/DR/HOTEL JA,10.0,18542.01,entertainment_dining_out
20 Mar 24,Debit,TO ONL UPI/DR/SARATH E,3600.0,14942.01,p2p_transfer
21 Mar 24,Debit,TO ONL UPI/DR/PEEKU PA,800.0,14142.01,p2p_transfer
21 Mar 24,Credit,BY NEFT TRF: BUNDL TECHNOLOGI,6173.57,20315.58,other_income
22 Mar 24,Debit,TO ONL UPI/DR/HATSUN A,412.53,19903.05,p2p_transfer
23 Mar 24,Debit,TO MONTHLY MAINTENANCE CHARGES,649.0,19254.05,fees_charges
24 Mar 24,Debit,TO ONL UPI/DR/MR EZHIL,17300.0,1954.05,p2p_transfer
26 Mar 24,Credit,BY NEFT TRF: BUNDL TECHNOLOGI,10021.32,11975.37,other_income
26 Mar 24,Debit,TO ONL UPI/DR/NAVEENKU,2520.0,9455.37,p2p_transfer
27 Mar 24,Credit,BY NEFT TRF: ZOMATO LIMITED,18385.88,27841.25,other_income
27 Mar 24,Debit,TO ONL UPI/DR/CHANDRU,2500.0,25341.25,p2p_transfer
28 Mar 24,Credit,BY NEFT TRF: BUNDL TECHNOLOGI,8037.66,33378.91,other_income
28 Mar 24,Debit,TO ONL UPI/DR/ROSHAN T,27764.0,5614.91,p2p_transfer
01 Apr 24,Debit,TO ONL UPI/DR/R THANGA,100.0,5514.91,p2p_transfer
03 Apr 24,Credit,BY NEFT TRF : ZOMATO LIMITED,18348.43,23863.34,other_income
03 Apr 24,Credit,BY NEFT TRF: BUNDL TECHNOLOGI,9722.31,33585.65,other_income
04 Apr 24,Debit,TO ONL UPI/DR/SRIIYANA,30450.0,3135.65,p2p_transfer
04 Apr 24,Debit,TO ONL UPI/DR/JAIHIND,10.0,3125.65,entertainment_dining_out
04 Apr 24,Credit,BY ONL 0000IMPSAXB409600992799 : GOOGLEINDI,1845.0,4970.65,other_income
05 Apr 24,Credit,BY NEFT TRF: BUNDL TECHNOLOGI,3333.13,8303.78,other_income
05 Apr 24,Debit,TO ONL UPI/DR/KUMAR TR,2500.0,5803.78,p2p_transfer
06 Apr 24,Credit,BY ONL 0000IMPSAXB409800249890 : GOOGLEINDI,2280.0,8083.78,other_income
07 Apr 24,Credit,BY CREDIT: IMPS MANUAL CR,1880.0,9963.78,other_income
08 Apr 24,Credit,BY ONL 0000IMPSAXB409901537175 : GOOGLEINDI,2625.0,12588.78,other_income
08 Apr 24,Debit,TO ONL UPI/DR/KARTHIKR,40.0,12548.78,p2p_transfer
09 Apr 24,Credit,BY ONL 0000IMPSAXB410001098391 : GOOGLEINDI,1920.0,14468.78,other_income
09 Apr 24,Credit,BY NEFT TRF: BUNDL TECHNOLOGI,12887.06,27355.84,other_income
10 Apr 24,Credit,BY ONL 0000IMPSAXB410101372399 : GOOGLEINDI,2371.0,29726.84,other_income
10 Apr 24,Credit,BY NEFT TRF : ZOMATO LIMITED,15142.27,44869.11,other_income
10 Apr 24,Credit,BY ONL 0000IMPSAXB410201042645 : GOOGLEINDI,4190.0,49059.11,other_income
12 Apr 24,Credit,BY ONL 0000IMPSAXB410301594122 : GOOGLEINDI,2280.0,51339.11,other_income
12 Apr 24,Credit,BY NEFT TRF: BUNDL TECHNOLOGI,8373.38,59712.49,other_income
12 Apr 24,Debit,TO ONL UPI/DR/ANNAI ST,7260.0,52452.49,p2p_transfer
12 Apr 24,Debit,TO ONL UPI/DR/99400726,15500.0,36952.49,p2p_transfer
12 Apr 24,Debit,UPI/DR/HOTEL JA,10.0,36942.49,entertainment_dining_out
12 Apr 24,Debit,UPI/DR/RTHANGAM,10.0,36932.49,miscellaneous_expense
12 Apr 24,Credit,REVERSAL FOR JOURNAL,10.0,36942.49,refund_reversal
12 Apr 24,Debit,UPI/DR/GAJASHIC,12060.0,24882.49,miscellaneous_expense
12 Apr 24,Credit,IMPS/GOOGLEINDI,1355.0,26237.49,other_income
13 Apr 24,Credit,IMPS/GOOGLEINDI,2165.0,28402.49,other_income
14 Apr 24,Debit,UPI/DR/ROSHAN T,16404.0,11998.49,miscellaneous_expense
14 Apr 24,Debit,UPI/DR/NAVEENKU,1600.0,10398.49,miscellaneous_expense
15 Apr 24,Credit,IMPS/GOOGLEINDI,3530.0,13928.49,other_income
16 Apr 24,Credit,IMPS/GOOGLEINDI,2325.0,16253.49,other_income
16 Apr 24,Credit,NEFT/BUNDL TECHNOLOGI,15000.44,31253.93,business_income
16 Apr 24,Debit,UPI/DR/MUHAMMED,1240.0,30013.93,miscellaneous_expense
17 Apr 24,Credit,IMPS/GOOGLEINDI,1400.0,31413.93,other_income
17 Apr 24,Credit,NEFT/ZOMATO LIMITED,21953.19,53367.12,business_income
18 Apr 24,Credit,IMPS/GOOGLEINDI,1735.0,55102.12,other_income
18 Apr 24,Credit,NEFT/BUNDL TECHNOLOGI,9510.85,64612.97,business_income
18 Apr 24,Debit,UPI/DR/PARTHIPA,1.0,64611.97,miscellaneous_expense
19 Apr 24,Credit,IMPS/GOOGLEINDI,1550.0,66161.97,other_income
19 Apr 24,Debit,ATM WDL,20000.0,46161.97,cash_withdrawal
19 Apr 24,Debit,ATM WDL,20000.0,26161.97,cash_withdrawal
19 Apr 24,Debit,ATM WDL,20000.0,6161.97,cash_withdrawal
20 Apr 24,Credit,IMPS/GOOGLEINDI,1820.0,7981.97,other_income
21 Apr 24,Credit,IMPS/GOOGLEINDI,1830.0,9811.97,other_income
21 Apr 24,Debit,MONTHLY MAINTENANCE CHARGES,590.0,9221.97,fees_charges
21 Apr 24,Credit,IMPS/GOOGLEINDI,2880.0,12101.97,other_income
22 Apr 24,Debit,UPI/DR/WWWSEKAR,8500.0,3601.97,miscellaneous_expense
22 Apr 24,Credit,IMPS/HOTEL JAIH,50000.0,53601.97,other_income
22 Apr 24,Debit,ATM WDL,20000.0,33601.97,cash_withdrawal
22 Apr 24,Debit,ATM WDL,20000.0,13601.97,cash_withdrawal
22 Apr 24,Debit,ATM WDL,10000.0,3601.97,cash_withdrawal
22 Apr 24,Debit,UPI/DR/APOLLO P,502.26,3099.71,healthcare_pharmacy
22 Apr 24,Credit,IMPS/GOOGLEINDI,1920.0,5019.71,other_income
23 Apr 24,Credit,NEFT/BUNDL TECHNOLOGI,8222.61,13242.32,business_income
24 Apr 24,Credit,IMPS/GOOGLEINDI,2820.0,16062.32,other_income
24 Apr 24,Credit,NEFT/ZOMATO LIMITED,23419.06,39481.38,business_income
24 Apr 24,Credit,IMPS/GOOGLEINDI,2160.0,41641.38,other_income
25 Apr 24,Credit,NEFT/BUNDL TECHNOLOGI,3714.07,45355.45,business_income
26 Apr 24,Credit,IMPS/GOOGLEINDI,1810.0,47165.45,other_income
26 Apr 24,Credit,IMPS/GOOGLEINDI,1650.0,48815.45,other_income
27 Apr 24,Credit,IMPS/GOOGLEINDI,1495.0,50310.45,other_income
28 Apr 24,Debit,SMS CHARGES,33.0,50277.45,fees_charges
28 Apr 24,Credit,IMPS/GOOGLEINDI,1865.0,52142.45,other_income
29 Apr 24,Credit,IMPS/GOOGLEINDI,2345.0,54487.45,other_income
30 Apr 24,Debit,ATM WDL,20000.0,34487.45,cash_withdrawal
30 Apr 24,Debit,ATM WDL,20000.0,14487.45,cash_withdrawal
30 Apr 24,Debit,ATM WDL,10000.0,4487.45,cash_withdrawal
30 Apr 24,Credit,NEFT/BUNDL TECHNOLOGI,10612.81,15100.26,business_income
30 Apr 24,Credit,IMPS/GOOGLEINDI,3040.0,18140.26,other_income
01 May 24,Credit,NEFT/ZOMATO LIMITED,20439.16,38579.42,business_income
02 May 24,Credit,IMPS/GOOGLEINDI,2203.0,40782.42,other_income
02 May 24,Debit,UPI/DR/R THANGA,20000.0,20782.42,miscellaneous_expense
02 May 24,Credit,IMPS/GOOGLEINDI,2325.0,23107.42,other_income
04 May 24,Credit,IMPS/GOOGLEINDI,2775.0,25882.42,other_income
04 May 24,Debit,UPI/DR/APOLLO P,684.45,25197.97,healthcare_pharmacy
04 May 24,Debit,UPI/DR/DEVENDHI,1400.0,23797.97,miscellaneous_expense
04 May 24,Debit,UPI/DR/DHANASIL,3900.0,19897.97,miscellaneous_expense
04 May 24,Debit,UPI/DR/SARAVANA,1350.0,18547.97,miscellaneous_expense
04 May 24,Debit,UPI/DR/SATHIKAL,420.0,18127.97,miscellaneous_expense
04 May 24,Debit,UPI/DR/BIJU MAT,320.0,17807.97,miscellaneous_expense
04 May 24,Debit,UPI/DR/KARPAGAM,230.0,17577.97,miscellaneous_expense
04 May 24,Debit,UPI/DR/RAJA MOH,800.0,16777.97,miscellaneous_expense
04 May 24,Debit,UPI/DR/NALAM AN,1320.0,15457.97,miscellaneous_expense
04 May 24,Credit,NEFT/BUNDL TECHNOLOGI,8542.87,24000.84,business_income
04 May 24,Debit,UPI/DR/G CHOZH,390.0,23610.84,miscellaneous_expense
04 May 24,Debit,UPI/DR/NALAM AN,3280.0,20330.84,miscellaneous_expense
04 May 24,Debit,UPI/DR/BALAJI N,18023.0,2307.84,miscellaneous_expense
05 May 24,Credit,IMPS/GOOGLEINDI,3565.0,5872.84,other_income
06 May 24,Credit,IMPS/GOOGLEINDI,4242.0,10114.84,other_income
06 May 24,Credit,IMPS/GOOGLEINDI,3140.0,13254.84,other_income
07 May 24,Credit,NEFT/BUNDL TECHNOLOGI,16750.53,30005.37,business_income
07 May 24,Credit,GOOGLEINDI / IMPS,2410.0,32415.37,other_income
08 May 24,Credit,ZOMATO LIMITED,20967.61,53382.98,other_income
08 May 24,Credit,GOOGLEINDI / IMPS,2602.0,55984.98,other_income
09 May 24,Credit,BUNDL TECHNOLOGI,12307.99,68292.97,other_income
10 May 24,Credit,GOOGLEINDI / IMPS,2958.0,71250.97,other_income
11 May 24,Credit,GOOGLEINDI / IMPS,2727.0,73977.97,other_income
11 May 24,Debit,MONTHLY MAINTENANCE CHARGES,531.0,73446.97,fees_charges
11 May 24,Debit,UPI/GEETA DE,24300.0,49146.97,p2p_transfer
11 May 24,Debit,UPI/GEETA DE,23250.0,25896.97,p2p_transfer
11 May 24,Debit,UPI/GEETA DE,15000.0,10896.97,p2p_transfer
12 May 24,Credit,GOOGLEINDI / IMPS,3460.0,14356.97,other_income
12 May 24,Debit,OPENING ACCOUNT WITH BALANCE,50.0,14306.97,fees_charges
12 May 24,Debit,UPI,1950.0,12356.97,miscellaneous_expense
13 May 24,Credit,GOOGLEINDI / IMPS,3285.0,15641.97,other_income
13 May 24,Debit,UPI/MARIAPPA,3500.0,12141.97,p2p_transfer
14 May 24,Credit,GOOGLEINDI / IMPS,3205.0,15346.97,other_income
14 May 24,Credit,BUNDL TECHNOLOGI,20140.76,35487.73,other_income
15 May 24,Credit,GOOGLEINDI / IMPS,2190.0,37677.73,other_income
15 May 24,Debit,UPI/TASMAC S,1420.0,36257.73,miscellaneous_expense
15 May 24,Debit,UPI/R THANGA,10000.0,26257.73,p2p_transfer
15 May 24,Credit,ZOMATO LIMITED,19500.53,45758.26,other_income
15 May 24,Credit,GOOGLEINDI / IMPS,2067.0,47825.26,other_income
16 May 24,Credit,BUNDL TECHNOLOGI,11885.74,59711.0,other_income
16 May 24,Debit,UPI/MR RAJAC,3750.0,55961.0,p2p_transfer
16 May 24,Debit,UPI/MUTHUMAN,3700.0,52261.0,p2p_transfer
17 May 24,Credit,GOOGLEINDI / IMPS,2080.0,54341.0,other_income
18 May 24,Credit,GOOGLEINDI / IMPS,3030.0,57371.0,other_income
18 May 24,Debit,UPI/R THANGA,20000.0,37371.0,p2p_transfer
18 May 24,Debit,UPI/SADHAM H,7500.0,29871.0,p2p_transfer
18 May 24,Credit,GOOGLEINDI / IMPS,2201.0,32072.0,other_income
19 May 24,Debit,UPI/MASTHANG,26673.0,5399.0,p2p_transfer
19 May 24,Debit,UPI/MUTHUMAN,4750.0,649.0,p2p_transfer
19 May 24,Credit,GOOGLEINDI / IMPS,2370.0,3019.0,other_income
20 May 24,Credit,GOOGLEINDI / IMPS,1630.0,4649.0,other_income
21 May 24,Credit,BUNDL TECHNOLOGI,16916.86,21565.86,other_income
22 May 24,Credit,GOOGLEINDI / IMPS,2155.0,23720.86,other_income
22 May 24,Debit,UPI/BP TRICH,4289.0,19431.86,p2p_transfer
22 May 24,Credit,ZOMATO LIMITED,21147.99,40579.85,other_income
22 May 24,Credit,GOOGLEINDI / IMPS,1525.0,42104.85,other_income
23 May 24,Credit,BUNDL TECHNOLOGI,10358.94,52463.79,other_income
24 May 24,Credit,GOOGLEINDI / IMPS,2020.0,54483.79,other_income
24 May 24,Debit,UPI/MUTHUMAN,3800.0,50683.79,p2p_transfer
24 May 24,Debit,UPI/SADHAM H,5800.0,44883.79,p2p_transfer
24 May 24,Debit,UPI/PARTHIPA,3600.0,41283.79,p2p_transfer
25 May 24,Credit,GOOGLEINDI / IMPS,2365.0,43648.79,other_income
26 May 24,Credit,GOOGLEINDI / IMPS,3195.0,46843.79,other_income
27 May 24,Credit,GOOGLEINDI / IMPS,2735.0,49578.79,other_income
27 May 24,Credit,GOOGLEINDI / IMPS,2265.0,51843.79,other_income
28 May 24,Debit,UPI/TASMAC S,2100.0,49743.79,miscellaneous_expense
28 May 24,Credit,BUNDL TECHNOLOGI,16056.7,65800.49,other_income
28 May 24,Debit,UPI/R THANGA,27000.0,38800.49,p2p_transfer
28 May 24,Debit,UPI/SM RIYAS,13500.0,25300.49,p2p_transfer
29 May 24,Credit,GOOGLEINDI / IMPS,2851.0,28151.49,other_income
29 May 24,Credit,ZOMATO LIMITED,22973.23,51124.72,other_income
29 May 24,Debit,UPI/M S HARS,19353.0,31771.72,p2p_transfer
30 May 24,Credit,GOOGLEINDI / IMPS,2795.0,34566.72,other_income
30 May 24,Debit,UPI/GOOGLE I,30000.0,4566.72,p2p_transfer
30 May 24,Credit,BUNDL TECHNOLOGI,11336.53,15903.25,other_income
30 May 24,Credit,GOOGLEINDI / IMPS,3289.0,19192.25,other_income
31 May 24,Credit,GOOGLEINDI / IMPS,3385.0,22577.25,other_income
01 Jun 24,Debit,UPI/MR A SUN,20000.0,2577.25,p2p_transfer
01 Jun 24,Credit,GOOGLEINDI / IMPS,3140.0,5717.25,other_income
03 Jun 24,Credit,GOOGLEINDI / IMPS,3205.0,8922.25,other_income
04 Jun 24,Credit,GOOGLEINDI / IMPS,2160.0,11082.25,other_income
04 Jun 24,Debit,UPI/SARATH E,4056.0,7026.25,p2p_transfer
04 Jun 24,Debit,UPI/K JAYARA,1400.0,5626.25,p2p_transfer
04 Jun 24,Debit,UPI/ATBALAJI,3000.0,2626.25,p2p_transfer
04 Jun 24,Credit,BUNDL TECHNOLOGI,17370.71,19996.96,other_income
04 Jun 24,Debit,UPI/B KALLAV,10000.0,9996.96,p2p_transfer
04 Jun 24,Credit,GOOGLEINDI / IMPS,2265.0,12261.96,other_income
05 Jun 24,Credit,NEFT TRF: ZOMATO LIMITED,20784.3,33046.26,business_income
05 Jun 24,Credit,ONL IMPS: GOOGLEINDI,2265.0,35311.26,other_income
06 Jun 24,Credit,ONL IMPS: GOOGLEINDI,1615.0,36926.26,other_income
07 Jun 24,Credit,NEFT TRF: BUNDL TECHNOLOGI,13970.01,50896.27,business_income
08 Jun 24,Credit,ONL IMPS: GOOGLEINDI,2610.0,53506.27,other_income
09 Jun 24,Credit,CREDIT: IMPS MANUAL CR,2980.0,56486.27,other_income
09 Jun 24,Debit,ONL UPI/DR: POTHYS,4752.0,51734.27,shopping
09 Jun 24,Credit,ONL IMPS: GOOGLEINDI,3180.0,54914.27,other_income
10 Jun 24,Debit,ONL UPI/DR: SUBHAM K,18600.0,36314.27,p2p_transfer
10 Jun 24,Debit,ONL UPI/DR: MOHIT KU,15000.0,21314.27,p2p_transfer
10 Jun 24,Debit,ONL UPI/DR: PUSHPA D,4400.0,16914.27,p2p_transfer
10 Jun 24,Debit,ONL UPI/DR: VELV0884,8520.0,8394.27,p2p_transfer
10 Jun 24,Debit,ONL UPI/DR: B KALLAV,7200.0,1194.27,p2p_transfer
11 Jun 24,Credit,ONL IMPS: GOOGLEINDI,2175.0,3369.27,other_income
11 Jun 24,Credit,NEFT TRF: BUNDL TECHNOLOGI,11478.27,14847.54,business_income
11 Jun 24,Debit,ONL UPI/DR: 98402375,4475.0,10372.54,p2p_transfer
11 Jun 24,Debit,ONL UPI/DR: CHAITHRA,5000.0,5372.54,p2p_transfer
11 Jun 24,Credit,ONL IMPS: GOOGLEINDI,3255.0,8627.54,other_income
12 Jun 24,Credit,NEFT TRF: ZOMATO LIMITED,21436.83,30064.37,business_income
12 Jun 24,Debit,ONL UPI/DR: MASTHANG,19727.0,10337.37,p2p_transfer
12 Jun 24,Credit,ONL IMPS: GOOGLEINDI,2260.0,12597.37,other_income
13 Jun 24,Credit,NEFT TRF: BUNDL TECHNOLOGI,9057.14,21654.51,business_income
14 Jun 24,Credit,ONL IMPS: GOOGLEINDI,2400.0,24054.51,other_income
14 Jun 24,Credit,ONL IMPS: GOOGLEINDI,3060.0,27114.51,other_income
15 Jun 24,Debit,ONL UPI/DR: SRINIVAS,3760.0,23354.51,p2p_transfer
15 Jun 24,Debit,ONL UPI/DR: LEGEND S,2652.0,20702.51,p2p_transfer
16 Jun 24,Credit,ONL IMPS: GOOGLEINDI,2630.0,23332.51,other_income
16 Jun 24,Debit,MONTHLY MAINTENANCE CHARGES,531.0,22801.51,fees_charges
16 Jun 24,Debit,ONL UPI/DR: B KALLAV,6000.0,16801.51,p2p_transfer
16 Jun 24,Debit,ONL UPI/DR: MR NAVEE,5600.0,11201.51,p2p_transfer
16 Jun 24,Debit,ONL UPI/DR: MRS J SE,2290.0,8911.51,p2p_transfer
16 Jun 24,Debit,ONL UPI: BILL,1401.0,7510.51,utilities
16 Jun 24,Debit,ONL UPI/DR: MR AROKK,5500.0,2010.51,p2p_transfer
17 Jun 24,Credit,ONL IMPS: GOOGLEINDI,2450.0,4460.51,other_income
17 Jun 24,Debit,ONL UPI/DR: M PACHI,600.0,3860.51,p2p_transfer
17 Jun 24,Debit,ONL UPI/DR: EAST WES,3000.0,860.51,p2p_transfer
17 Jun 24,Credit,ONL IMPS: GOOGLEINDI,2445.0,3305.51,other_income
18 Jun 24,Credit,NEFT TRF: BUNDL TECHNOLOGI,6653.34,9958.85,business_income
18 Jun 24,Credit,ONL IMPS: GOOGLEINDI,1810.0,11768.85,other_income
19 Jun 24,Credit,NEFT TRF: ZOMATO LIMITED,23805.4,35574.25,business_income
19 Jun 24,Debit,ONL UPI/DR: PANDIYAN,9230.0,26344.25,p2p_transfer
19 Jun 24,Debit,ONL UPI/DR: PANDIYAN,934.0,25410.25,p2p_transfer
20 Jun 24,Credit,ONL IMPS: GOOGLEINDI,2345.0,27755.25,other_income
20 Jun 24,Credit,NEFT TRF: BUNDL TECHNOLOGI,7915.46,35670.71,business_income
20 Jun 24,Debit,ONL UPI/DR: GOOGLE I,30000.0,5670.71,p2p_transfer
21 Jun 24,Credit,ONL IMPS: GOOGLEINDI,2644.0,8314.71,other_income
21 Jun 24,Credit,ONL IMPS: GOOGLEINDI,2990.0,11304.71,other_income
23 Jun 24,Credit,ONL IMPS: GOOGLEINDI,2795.0,14099.71,other_income
23 Jun 24,Credit,ONL UPI/CR: MS KALAV,10000.0,24099.71,other_income
23 Jun 24,Debit,ONL UPI/DR: GOOGLE I,20000.0,4099.71,p2p_transfer
23 Jun 24,Credit,ONL IMPS: GOOGLEINDI,2884.0,6983.71,other_income
25 Jun 24,Credit,ONL IMPS: GOOGLEINDI,1320.0,8303.71,other_income
25 Jun 24,Credit,NEFT TRF: BUNDL TECHNOLOGI,7251.37,15555.08,business_income
25 Jun 24,Credit,ONL IMPS: GOOGLEINDI,2200.0,17755.08,other_income
26 Jun 24,Credit,NEFT TRF: ZOMATO LIMITED,29342.51,47097.59,business_income
27 Jun 24,Credit,ONL IMPS: GOOGLEINDI,2157.0,49254.59,other_income
27 Jun 24,Credit,NEFT TRF: BUNDL TECHNOLOGI,7806.25,57060.84,business_income
27 Jun 24,Credit,ONL IMPS: GOOGLEINDI,2355.0,59415.84,other_income
28 Jun 24,Debit,ONL UPI/DR: RTHANGAM,1.0,59414.84,p2p_transfer
28 Jun 24,Credit,ONL REVERSAL FOR JOURNAL,1.0,59415.84,refund_reversal
28 Jun 24,Debit,ONL UPI/DR: MR A SUN,25760.0,33655.84,p2p_transfer
28 Jun 24,Debit,ONL UPI/DR: T MANIVE,30000.0,3655.84,p2p_transfer
29 Jun 24,Credit,ONL IMPS: GOOGLEINDI,3305.0,6960.84,other_income
29 Jun 24,Credit,ONL IMPS: GOOGLEINDI,3062.0,10022.84,other_income
30 Jun 24,Credit,ONL IMPS: ONE97 COMM,1.0,10023.84,other_income
30 Jun 24,Debit,ONL UPI/DR: MRS J SE,2090.0,7933.84,p2p_transfer
01 Jul 24,Credit,NEFT TRF: ONE 97 COMMUNICA,8510.0,16443.84,business_income
01 Jul 24,Debit,ONL UPI/DR: GAJASHIC,14900.0,1543.84,p2p_transfer
02 Jul 24,Credit,NEFT TRF: ONE 97 COMMUNICA,5570.0,7113.84,business_income
03 Jul 24,Credit,NEFT TRF: ONE 97 COMMUNICA,4407.0,11520.84,business_income
03 Jul 24,Credit,NEFT TRF/ZOMATO LIMITED,22878.31,34399.15,other_income
04 Jul 24,Credit,NEFT TRF/ONE 97 COMMUNICA,1208.0,35607.15,other_income
04 Jul 24,Debit,UPI/P JAYALA,1120.0,34487.15,p2p_transfer
04 Jul 24,Credit,NEFT TRF/BUNDL TECHNOLOGI,12048.57,46535.72,other_income
04 Jul 24,Debit,UPI/ROSHAN T,37270.0,9265.72,p2p_transfer
04 Jul 24,Debit,UPI/B KALLAV,4000.0,5265.72,p2p_transfer
05 Jul 24,Debit,UPI/R THANGA,3000.0,2265.72,p2p_transfer
05 Jul 24,Credit,NEFT TRF/ONE 97 COMMUNICA,4349.72,6615.44,other_income
06 Jul 24,Credit,NEFT TRF/ONE 97 COMMUNICA,3130.0,9745.44,other_income
07 Jul 24,Debit,UPI/POTHYS P,3732.0,6013.44,shopping
08 Jul 24,Debit,UPI/PUSHPA D,1700.0,4313.44,p2p_transfer
08 Jul 24,Debit,UPI/THANGAMA,3000.0,1313.44,p2p_transfer
09 Jul 24,Credit,NEFT TRF/ONE 97 COMMUNICA,1576.0,2889.44,other_income
09 Jul 24,Credit,NEFT TRF/BUNDL TECHNOLOGI,14088.61,16978.05,other_income
10 Jul 24,Credit,NEFT TRF/ONE 97 COMMUNICA,5880.22,22858.27,other_income
10 Jul 24,Credit,NEFT TRF/ZOMATO LIMITED,23810.54,46668.81,other_income
11 Jul 24,Credit,NEFT TRF/ONE 97 COMMUNICA,3488.0,50156.81,other_income
11 Jul 24,Credit,NEFT TRF/BUNDL TECHNOLOGI,10334.55,60491.36,other_income
12 Jul 24,Credit,NEFT TRF/ONE 97 COMMUNICA,7050.7,67542.06,other_income
13 Jul 24,Credit,NEFT TRF/ONE 97 COMMUNICA,4219.0,71761.06,other_income
14 Jul 24,Credit,NEFT TRF/ONE 97 COMMUNICA,11620.46,83381.52,other_income
15 Jul 24,Credit,NEFT TRF/ONE 97 COMMUNICA,3679.08,87060.6,other_income
16 Jul 24,Credit,NEFT TRF/ONE 97 COMMUNICA,610.0,87670.6,other_income
16 Jul 24,Credit,NEFT TRF/BUNDL TECHNOLOGI,8958.38,96628.98,other_income
17 Jul 24,Credit,IMPS/GOOGLEINDI,1.0,96629.98,other_income
17 Jul 24,Credit,NEFT TRF/ONE 97 COMMUNICA,4109.0,100738.98,other_income
17 Jul 24,Credit,NEFT TRF/ZOMATO LIMITED,22332.68,123071.66,other_income
17 Jul 24,Debit,ATM WDL/VARDRAJPURAM II THIRUVALLUR TNIN,20000.0,103071.66,cash_withdrawal
17 Jul 24,Debit,ATM WDL/VARDRAJPURAM II THIRUVALLUR TNIN,20000.0,83071.66,cash_withdrawal
17 Jul 24,Debit,ATM WDL/VARDRAJPURAM II THIRUVALLUR TNIN,20000.0,63071.66,cash_withdrawal
18 Jul 24,Credit,NEFT TRF/ONE 97 COMMUNICA,3495.0,66566.66,other_income
18 Jul 24,Credit,NEFT TRF/BUNDL TECHNOLOGI,8279.28,74845.94,other_income
19 Jul 24,Credit,NEFT TRF/ONE 97 COMMUNICA,2068.0,76913.94,other_income
20 Jul 24,Credit,NEFT TRF/ONE 97 COMMUNICA,2846.0,79759.94,other_income
21 Jul 24,Credit,NEFT TRF/ONE 97 COMMUNICA,4386.0,84145.94,other_income
22 Jul 24,Credit,NEFT TRF/ONE 97 COMMUNICA,3617.0,87762.94,other_income
23 Jul 24,Credit,NEFT TRF/ONE 97 COMMUNICA,2828.0,90590.94,other_income
23 Jul 24,Debit,UPI/MR A SUN,46800.0,43790.94,p2p_transfer
23 Jul 24,Debit,UPI/MASTHANG,30000.0,13790.94,p2p_transfer
23 Jul 24,Credit,NEFT TRF/BUNDL TECHNOLOGI,7750.85,21541.79,other_income
23 Jul 24,Debit,UPI/N CHITIY,15000.0,6541.79,p2p_transfer
24 Jul 24,Credit,NEFT TRF/ONE 97 COMMUNICA,1697.0,8238.79,other_income
24 Jul 24,Credit,NEFT TRF/ZOMATO LIMITED,26127.37,34366.16,other_income
25 Jul 24,Credit,NEFT TRF/ONE 97 COMMUNICA,6624.77,40990.93,other_income
25 Jul 24,Credit,NEFT TRF/BUNDL TECHNOLOGI,7838.71,48829.64,other_income
25 Jul 24,Debit,UPI/KAVERI S,4360.0,44469.64,p2p_transfer
25 Jul 24,Debit,UPI/BALAJI N,26574.0,17895.64,p2p_transfer
25 Jul 24,Debit,UPI/PARTHIAN,5530.0,12365.64,p2p_transfer
25 Jul 24,Debit,UPI/PANDIYAN,6480.0,5885.64,p2p_transfer
26 Jul 24,Credit,NEFT TRF/ONE 97 COMMUNICA,6508.0,12393.64,other_income
27 Jul 24,Debit,MONTHLY MAINTENANCE CHARGES,590.0,11803.64,fees_charges
27 Jul 24,Debit,SMS CHARGES,30.0,11773.64,fees_charges
27 Jul 24,Credit,NEFT TRF/ONE 97 COMMUNICA,3142.0,14915.64,other_income
28 Jul 24,Credit,NEFT TRF/ONE 97 COMMUNICA,10318.29,25233.93,other_income
29 Jul 24,Credit,NEFT TRF/ONE 97 COMMUNICA,4372.65,29606.58,other_income
30 Jul 24,Credit,NEFT TRF/ONE 97 COMMUNICA,2743.0,32349.58,other_income
30 Jul 24,Credit,NEFT TRF/BUNDL TECHNOLOGI,9223.91,41573.49,other_income
31 Jul 24,Credit,NEFT TRF/ONE 97 COMMUNICA,8784.41,50357.9,other_income
31 Jul 24,Credit,NEFT TRF/ZOMATO LIMITED,18969.43,69327.33,other_income
01 Aug 24,Credit,NEFT TRF/ONE 97 COMMUNICA,1940.0,71267.33,other_income
01 Aug 24,Debit,UPI/WINEDWIN,2000.0,69267.33,p2p_transfer
02 Aug 24,Credit,NEFT TRF/ONE 97 COMMUNICA,3058.0,72325.33,other_income
02 Aug 24,Debit,UPI/SARATH E,2000.0,70325.33,p2p_transfer
03 Aug 24,Credit,NEFT TRF/ONE 97 COMMUNICA,550.0,70875.33,other_income
03 Aug 24,Debit,UPI/SARAVANA,64582.0,6293.33,p2p_transfer
04 Aug 24,Credit,NEFT TRF/ONE 97 COMMUNICA,2822.0,9115.33,other_income
05 Aug 24,Credit,NEFT TRF/ONE 97 COMMUNICA,6438.0,15553.33,other_income
05 Aug 24,Debit,UPI/DINESH26,4500.0,11053.33,p2p_transfer
06 Aug 24,Credit,NEFT TRF/BUNDL TECHNOLOGI,12855.48,23908.81,other_income
06 Aug 24,Credit,NEFT TRF/ONE 97 COMMUNICA,4224.0,28132.81,other_income
07 Aug 24,Credit,NEFT TRF/ONE 97 COMMUNICA,4379.66,32512.47,other_income
07 Aug 24,Credit,NEFT TRF/ZOMATO LIMITED,21746.9,54259.37,other_income
08 Aug 24,Credit,NEFT TRF/ONE 97 COMMUNICA,4590.0,58849.37,other_income
08 Aug 24,Credit,NEFT TRF/BUNDL TECHNOLOGI,8203.58,67052.95,other_income
09 Aug 24,Credit,NEFT TRF/ONE 97 COMMUNICA,4595.0,71647.95,other_income
09 Aug 24,Credit,NEFT TRF/BUNDL TECHNOLOGI,12024.76,83672.71,other_income
10 Aug 24,Credit,NEFT TRF/ONE 97 COMMUNICA,1939.0,85611.71,other_income
10 Aug 24,Debit,UPI/KAILASH,9600.0,76011.71,p2p_transfer
10 Aug 24,Debit,UPI/ROSHAN T,24656.0,51355.71,p2p_transfer
10 Aug 24,Debit,UPI/VELAN TR,17236.0,34119.71,p2p_transfer
10 Aug 24,Debit,UPI/MASTHANG,29847.0,4272.71,p2p_transfer
11 Aug 24,Credit,NEFT TRF/ONE 97 COMMUNICA,8395.0,12667.71,other_income
12 Aug 24,Credit,NEFT TRF/ONE 97 COMMUNICA,6752.0,19419.71,other_income
12 Aug 24,Debit,UPI/R THANGA,18000.0,1419.71,p2p_transfer
13 Aug 24,Credit,NEFT TRF/ONE 97 COMMUNICA,4711.0,6130.71,other_income
13 Aug 24,Debit,UPI/HNRS FRU,740.0,5390.71,p2p_transfer
13 Aug 24,Debit,UPI/R B FRUI,650.0,4740.71,p2p_transfer
13 Aug 24,Debit,UPI/PANDIYAN,2800.0,1940.71,p2p_transfer
13 Aug 24,Debit,UPI/RAKESH J,850.0,1090.71,p2p_transfer
13 Aug 24,Debit,UPI/SARAVA L,621.0,469.71,p2p_transfer
13 Aug 24,Credit,NEFT TRF/BUNDL TECHNOLOGI,16473.23,16942.94,other_income
14 Aug 24,Credit,NEFT TRF/ONE 97 COMMUNICA,4017.0,20959.94,other_income
14 Aug 24,Credit,NEFT TRF/ZOMATO LIMITED,20006.07,40966.01,other_income
14 Aug 24,Debit,UPI/MR AROKK,2400.0,38566.01,p2p_transfer
14 Aug 24,Debit,UPI/B KALLAV,8400.0,30166.01,p2p_transfer
14 Aug 24,Debit,UPI/E RAJASE,3000.0,27166.01,p2p_transfer
15 Aug 24,Credit,NEFT TRF/ONE 97 COMMUNICA,4285.0,31451.01,other_income
16 Aug 24,Credit,NEFT TRF/ONE 97 COMMUNICA,7668.67,39119.68,other_income
16 Aug 24,Credit,NEFT TRF/BUNDL TECHNOLOGI,7305.57,46425.25,other_income
17 Aug 24,Credit,NEFT TRF/ONE 97 COMMUNICA,2332.0,48757.25,other_income
18 Aug 24,Credit,NEFT TRF/ONE 97 COMMUNICA,7163.0,55920.25,other_income
18 Aug 24,Debit,UPI/ROSHAN T,34662.0,21258.25,p2p_transfer
19 Aug 24,Credit,NEFT TRF/ONE 97 COMMUNICA,6370.0,27628.25,other_income
20 Aug 24,Credit,NEFT TRF/ONE 97 COMMUNICA,5110.0,32738.25,other_income
20 Aug 24,Credit,NEFT TRF/BUNDL TECHNOLOGI,5320.26,38058.51,other_income
21 Aug 24,Credit,NEFT TRF/ONE 97 COMMUNICA,6251.0,44309.51,other_income
21 Aug 24,Credit,NEFT TRF/ZOMATO LIMITED,21314.73,65624.24,other_income
22 Aug 24,Credit,NEFT TRF/ONE 97 COMMUNICA,3643.23,69267.47,other_income
22 Aug 24,Credit,NEFT TRF/BUNDL TECHNOLOGI,7800.06,77067.53,other_income
23 Aug 24,Credit,NEFT TRF/ONE 97 COMMUNICA,5584.0,82651.53,other_income
23 Aug 24,Debit,UPI/BALAJI N,33306.0,49345.53,p2p_transfer
23 Aug 24,Debit,UPI/RIDDHI S,35530.0,13815.53,p2p_transfer
24 Aug 24,Debit,MONTHLY MAINTENANCE CHARGES,531.0,13284.53,fees_charges
24 Aug 24,Credit,NEFT TRF/ONE 97 COMMUNICA,984.0,14268.53,other_income
25 Aug 24,Credit,NEFT TRF/ONE 97 COMMUNICA,7585.0,21853.53,other_income
25 Aug 24,Debit,UPI/AVICTORM,14040.0,7813.53,p2p_transfer
26 Aug 24,Credit,NEFT TRF/ONE 97 COMMUNICA,23580.0,31393.53,other_income
26 Aug 24,Debit,UPI/FASILA,17000.0,14393.53,p2p_transfer
26 Aug 24,Debit,UPI/AUTHILIN,10101.0,4292.53,p2p_transfer
27 Aug 24,Credit,NEFT TRF/ONE 97 COMMUNICA,3892.0,8184.53,other_income
27 Aug 24,Credit,NEFT TRF/BUNDL TECHNOLOGI,11339.09,19523.62,other_income
27 Aug 24,Debit,UPI/POTHYS,8714.0,10809.62,p2p_transfer
27 Aug 24,Debit,UPI/POTHYS,3845.0,6964.62,p2p_transfer
27 Aug 24,Debit,UPI/POTHYS,1524.0,5440.62,p2p_transfer
27 Aug 24,Debit,UPI/POTHYS,2840.0,2600.62,p2p_transfer
28 Aug 24,Credit,NEFT TRF/ONE 97 COMMUNICA,7519.23,10119.85,other_income
28 Aug 24,Credit,NEFT TRF/ZOMATO LIMITED,19339.56,29459.41,other_income
29 Aug 24,Credit,NEFT TRF/ONE 97 COMMUNICA,7123.0,36582.41,other_income
29 Aug 24,Credit,NEFT TRF/BUNDL TECHNOLOGI,8329.56,44911.97,other_income
30 Aug 24,Credit,NEFT TRF/ONE 97 COMMUNICA,1071.0,45982.97,other_income
31 Aug 24,Credit,NEFT TRF/ONE 97 COMMUNICA,12641.0,58623.97,other_income
01 Sep 24,Credit,NEFT TRF/ONE 97 COMMUNICA,3835.0,62458.97,other_income
02 Sep 24,Credit,NEFT TRF/ONE 97 COMMUNICA,16793.0,79251.97,other_income
02 Sep 24,Debit,UPI/MR A SUN,33200.0,46051.97,p2p_transfer
02 Sep 24,Debit,UPI/MASTHANG,29433.0,16618.97,p2p_transfer
02 Sep 24,Debit,UPI/PUSHPA D,6700.0,9918.97,p2p_transfer
02 Sep 24,Debit,UPI/B KALLAV,7200.0,2718.97,p2p_transfer
02 Sep 24,Credit,IMPS/GOOGLEINDI,701.0,3419.97,other_income
02 Sep 24,Credit,IMPS/GOOGLEINDI,755.0,4174.97,other_income
03 Sep 24,Credit,NEFT TRF/BUNDL TECHNOLOGI,12790.11,16965.08,other_income
04 Sep 24,Credit,BY ONL GOOGLEINDI / IMPS,1925.0,18890.08,other_income
04 Sep 24,Credit,BY NEFT TRF: ONE 97 COMMUNICA,870.0,19760.08,other_income
04 Sep 24,Credit,BY NEFT TRF: ZOMATO LIMITED,21479.62,41239.7,other_income
05 Sep 24,Credit,BY ONL GOOGLEINDI / IMPS,2192.0,43431.7,other_income
05 Sep 24,Debit,TO ONL UPI/DR/B KALLAV,10000.0,33431.7,p2p_transfer
05 Sep 24,Credit,BY NEFT TRF: BUNDL TECHNOLOGI,10170.23,43601.93,other_income
05 Sep 24,Debit,TO ONL UPI/DR/AKSHATBA,22200.0,21401.93,p2p_transfer
05 Sep 24,Debit,TO ONL UPI/DR/GAJASHIC,12920.0,8481.93,p2p_transfer
05 Sep 24,Debit,TO ONL UPI/DR/MRS J SE,1740.0,6741.93,p2p_transfer
05 Sep 24,Credit,BY ONL GOOGLEINDI/ IMPS,2652.0,9393.93,other_income
06 Sep 24,Credit,BY NEFT TRF: ONE 97 COMMUNICA,10.0,9403.93,other_income
07 Sep 24,Credit,BY ONL GOOGLEINDI / IMPS,2932.0,12335.93,other_income
07 Sep 24,Debit,TO ONL UPI/DR/MR JENSO,1100.0,11235.93,p2p_transfer
07 Sep 24,Credit,BY ONL GOOGLEINDI / IMPS,3616.0,14851.93,other_income
08 Sep 24,Credit,BY ONL GOOGLEINDI /IMPS,3375.0,18226.93,other_income
09 Sep 24,Credit,BY ONL GOOGLEINDI/IMPS,3192.0,21418.93,other_income
10 Sep 24,Credit,BY NEFT TRF: BUNDL TECHNOLOGI,13497.86,34916.79,other_income
10 Sep 24,Credit,BY ONL GOOGLEINDI / IMPS,2225.0,37141.79,other_income
11 Sep 24,Credit,BY NEFT TRF : ZOMATO LIMITED,21220.04,58361.83,other_income
12 Sep 24,Credit,BY ONL GOOGLEINDI / IMPS,4055.0,62416.83,other_income
12 Sep 24,Credit,BY NEFT TRF: BUNDL TECHNOLOGI,8167.35,70584.18,other_income
13 Sep 24,Credit,BY ONL GOOGLEINDI / IMPS,3015.0,73599.18,other_income
13 Sep 24,Debit,TO ONL UPI/DR/DINAKARA,30000.0,43599.18,p2p_transfer
13 Sep 24,Debit,TO ONL UPI/DR/NAGALING,40000.0,3599.18,p2p_transfer
14 Sep 24,Credit,BY ONL GOOGLEINDI / IMPS,2910.0,6509.18,other_income
14 Sep 24,Credit,BY ONL GOOGLEINDI / IMPS,3442.0,9951.18,other_income
16 Sep 24,Credit,BY ONL GOOGLEINDI / IMPS,3190.0,13141.18,other_income
17 Sep 24,Credit,BY ONL GOOGLEINDI / IMPS,3335.0,16476.18,other_income
17 Sep 24,Credit,BY NEFT TRF: BUNDL TECHNOLOGI,14325.03,30801.21,other_income
18 Sep 24,Credit,BY ONL GOOGLEINDI/ IMPS,2360.0,33161.21,other_income
18 Sep 24,Debit,TO ONL UPI/DR/MASTHANG,30000.0,3161.21,p2p_transfer
18 Sep 24,Credit,BY NEFT TRF : ZOMATO LIMITED,26571.23,29732.44,other_income
19 Sep 24,Credit,BY ONL GOOGLEINDI / IMPS,2900.0,32632.44,other_income
19 Sep 24,Credit,BY NEFT TRF: BUNDL TECHNOLOGI,7967.21,40599.65,other_income
20 Sep 24,Credit,BY ONL GOOGLEINDI / IMPS,3355.0,43954.65,other_income
20 Sep 24,Debit,TO ONL UPI :: BILL,1982.0,41972.65,fees_charges
20 Sep 24,Credit,BY ONL GOOGLEINDI / IMPS,3265.0,45237.65,other_income
22 Sep 24,Credit,BY ONL GOOGLEINDI / IMPS,2100.0,47337.65,other_income
22 Sep 24,Debit,TO MONTHLY MAINTENANCE CHARGES,531.0,46806.65,fees_charges
22 Sep 24,Credit,BY NEFT TRF: ONE 97 COMMUNICA,4758.0,51564.65,other_income
23 Sep 24,Credit,BY NEFT TRF: ONE 97 COMMUNICA,10965.0,62529.65,other_income
24 Sep 24,Credit,BY NEFT TRF: ONE 97 COMMUNICA,6801.0,69330.65,other_income
24 Sep 24,Credit,BY NEFT TRF: BUNDL TECHNOLOGI,13004.8,82335.45,other_income
25 Sep 24,Credit,BY NEFT TRF: ONE 97 COMMUNICA,7250.0,89585.45,other_income
25 Sep 24,Credit,BY NEFT TRF: ZOMATO LIMITED,18643.88,108229.33,other_income
26 Sep 24,Credit,BY NEFT TRF: ONE 97 COMMUNICA,4733.0,112962.33,other_income
27 Sep 24,Credit,BY NEFT TRF: ONE 97 COMMUNICA,1678.0,114640.33,other_income
27 Sep 24,Credit,BY NEFT TRF: BUNDL TECHNOLOGI,9012.01,123652.34,other_income
28 Sep 24,Credit,,3570.0,127222.34,other_income
29 Sep 24,Credit,BY NEFT TRF: ONE 97 COMMUNICA,3822.0,131044.34,other_income
29 Sep 24,Debit,TO ONL UPI/DR/AKSHATBA,62900.0,68144.34,p2p_transfer
30 Sep 24,Credit,BY ONL GOOGLEINDI / IMPS,80.0,68224.34,other_income
30 Sep 24,Credit,BY NEFT TRF: ONE 97 COMMUNICA,11336.0,79560.34,other_income
30 Sep 24,Debit,TO ONL UPI/DR/MR AROKK,5500.0,74060.34,p2p_transfer
30 Sep 24,Debit,TO ONL UPI/DR/PUSHPA D,6600.0,67460.34,p2p_transfer
30 Sep 24,Debit,TO ONL UPI/DR/MR NAVEE,4200.0,63260.34,p2p_transfer
30 Sep 24,Debit,TO ONL UPI/DR/MALAR EN,18000.0,45260.34,p2p_transfer
30 Sep 24,Debit,TO ONL UPI/DR/TLK GAS,22600.0,22660.34,p2p_transfer
30 Sep 24,Debit,TO ONL UPI/DR/VELAN TR,13263.0,9397.34,p2p_transfer
01 Oct 24,Credit,BY NEFT TRF: ONE 97 COMMUNICA,8121.74,17519.08,other_income
01 Oct 24,Credit,BY NEFT TRF : ZOMATO LIMITED,21526.71,39045.79,other_income
02 Oct 24,Credit,BY NEFT TRF: ONE 97 COMMUNICA,7046.0,46091.79,other_income
03 Oct 24,Credit,BY NEFT TRF: ONE 97 COMMUNICA,13879.0,59970.79,other_income
04 Oct 24,Credit,BY NEFT TRF: ONE 97 COMMUNICA,4125.96,64096.75,other_income
04 Oct 24,Credit,BY NEFT TRF: BUNDL TECHNOLOGI,21396.45,85493.2,other_income
04 Oct 24,Debit,TO ONL UPI/DR/MURUGAN,3000.0,82493.2,p2p_transfer
04 Oct 24,Debit,TO ONL UPI/DR/K JAYARA,4600.0,77893.2,p2p_transfer
04 Oct 24,Debit,TO ONL UPI/DR/RADHA D,975.0,76918.2,p2p_transfer
04 Oct 24,Debit,TO ONL UPI/DR/BIJU MAT,650.0,76268.2,p2p_transfer
04 Oct 24,Debit,TO ONL UPI/DR/BISMI FR,2400.0,73868.2,p2p_transfer
04 Oct 24,Debit,UPI/ANIL KUM,3400.0,70468.2,p2p_transfer
04 Oct 24,Debit,UPI/KAVERI S,6300.0,64168.2,p2p_transfer
04 Oct 24,Debit,UPI/PANDIYAN,7320.0,56848.2,p2p_transfer
04 Oct 24,Debit,UPI/BALAJI T,8820.0,48028.2,p2p_transfer
04 Oct 24,Debit,UPI/BALAJI N,28759.0,19269.2,p2p_transfer
04 Oct 24,Debit,UPI/SM RIYAS,19000.0,269.2,p2p_transfer
05 Oct 24,Credit,NEFT TRF: ONE 97 COMMUNICA,6112.0,6381.2,other_income
06 Oct 24,Credit,NEFT TRF: ONE 97 COMMUNICA,7990.0,14371.2,other_income
07 Oct 24,Credit,NEFT TRF: ONE 97 COMMUNICA,16870.47,31241.67,other_income
07 Oct 24,Debit,UPI/MRAMAR19,18000.0,13241.67,p2p_transfer
08 Oct 24,Credit,NEFT TRF: ONE 97 COMMUNICA,8422.0,21663.67,other_income
08 Oct 24,Debit,UPI/K CHANDR,3000.0,18663.67,p2p_transfer
08 Oct 24,Credit,NEFT TRF: BUNDL TECHNOLOGI,16601.31,35264.98,other_income
09 Oct 24,Credit,NEFT TRF: ONE 97 COMMUNICA,4736.0,40000.98,other_income
09 Oct 24,Credit,NEFT TRF: ZOMATO LIMITED,20994.68,60995.66,other_income
10 Oct 24,Credit,NEFT TRF: ONE 97 COMMUNICA,3307.0,64302.66,other_income
10 Oct 24,Credit,NEFT TRF: BUNDL TECHNOLOGI,10031.43,74334.09,other_income
11 Oct 24,Credit,NEFT TRF: ONE 97 COMMUNICA,4996.6,79330.69,other_income
12 Oct 24,Credit,NEFT TRF: ONE 97 COMMUNICA,3643.0,82973.69,other_income
13 Oct 24,Credit,NEFT TRF: ONE 97 COMMUNICA,11497.75,94471.44,other_income
14 Oct 24,Credit,NEFT TRF: ONE 97 COMMUNICA,8001.0,102472.44,other_income
14 Oct 24,Debit,ATM WDL,20000.0,82472.44,cash_withdrawal
14 Oct 24,Debit,ATM WDL,20000.0,62472.44,cash_withdrawal
14 Oct 24,Debit,ATM WDL,20000.0,42472.44,cash_withdrawal
15 Oct 24,Credit,NEFT TRF: ONE 97 COMMUNICA,911.0,43383.44,other_income
15 Oct 24,Credit,NEFT TRF: BUNDL TECHNOLOGI,11628.39,55011.83,other_income
15 Oct 24,Debit,UPI/B KALLAV,7200.0,47811.83,p2p_transfer
15 Oct 24,Debit,UPI/MR AROKK,5000.0,42811.83,p2p_transfer
15 Oct 24,Debit,UPI/PUSHPA D,7700.0,35111.83,p2p_transfer
15 Oct 24,Debit,UPI/MR NAVEE,3150.0,31961.83,p2p_transfer
16 Oct 24,Credit,NEFT TRF: ONE 97 COMMUNICA,920.72,32882.55,other_income
16 Oct 24,Credit,NEFT TRF: ZOMATO LIMITED,20922.11,53804.66,other_income
16 Oct 24,Debit,UPI/MR A SUN,41250.0,12554.66,p2p_transfer
17 Oct 24,Credit,NEFT TRF: ONE 97 COMMUNICA,2243.0,14797.66,other_income
17 Oct 24,Credit,NEFT TRF: BUNDL TECHNOLOGI,3666.47,18464.13,other_income
18 Oct 24,Credit,NEFT TRF: ONE 97 COMMUNICA,2008.0,20472.13,other_income
19 Oct 24,Credit,NEFT TRF: ONE 97 COMMUNICA,3323.0,23795.13,other_income
20 Oct 24,Debit,MONTHLY MAINTENANCE CHARGES,531.0,23264.13,fees_charges
20 Oct 24,Credit,NEFT TRF: ONE 97 COMMUNICA,3970.16,27234.29,other_income
21 Oct 24,Credit,NEFT TRF: ONE 97 COMMUNICA,5280.0,32514.29,other_income
21 Oct 24,Debit,UPI/GAJASHIC,28640.0,3874.29,p2p_transfer
22 Oct 24,Credit,NEFT TRF: ONE 97 COMMUNICA,2671.0,6545.29,other_income
22 Oct 24,Credit,NEFT TRF: BUNDL TECHNOLOGI,10635.59,17180.88,other_income
23 Oct 24,Credit,NEFT TRF: ONE 97 COMMUNICA,3529.0,20709.88,other_income
23 Oct 24,Credit,NEFT TRF: ZOMATO LIMITED,21587.13,42297.01,other_income
24 Oct 24,Credit,NEFT TRF: ONE 97 COMMUNICA,5433.68,47730.69,other_income
24 Oct 24,Debit,UPI/SARATH E,4120.0,43610.69,p2p_transfer
24 Oct 24,Credit,NEFT TRF: BUNDL TECHNOLOGI,6301.58,49912.27,other_income
25 Oct 24,Credit,NEFT TRF: ONE 97 COMMUNICA,1974.0,51886.27,other_income
26 Oct 24,Debit,SMS CHARGES,30.0,51856.27,fees_charges
26 Oct 24,Credit,NEFT TRF: ONE 97 COMMUNICA,55.0,51911.27,other_income
27 Oct 24,Credit,NEFT TRF: ONE 97 COMMUNICA,1812.0,53723.27,other_income
27 Oct 24,Debit,UPI/INDIAN O,1200.0,52523.27,p2p_transfer
27 Oct 24,Debit,UPI/S NIRMAL,1950.0,50573.27,p2p_transfer
28 Oct 24,Credit,NEFT TRF: ONE 97 COMMUNICA,3091.0,53664.27,other_income
29 Oct 24,Credit,NEFT TRF: ONE 97 COMMUNICA,5749.0,59413.27,other_income
29 Oct 24,Credit,NEFT TRF: BUNDL TECHNOLOGI,13725.2,73138.47,other_income
30 Oct 24,Credit,NEFT TRF: ONE 97 COMMUNICA,5445.15,78583.62,other_income
30 Oct 24,Credit,NEFT TRF: ZOMATO LIMITED,22860.79,101444.41,other_income
31 Oct 24,Credit,NEFT TRF: ONE 97 COMMUNICA,10900.0,112344.41,other_income
01 Nov 24,Credit,NEFT TRF: ONE 97 COMMUNICA,1439.0,113783.41,other_income
02 Nov 24,Credit,NEFT TRF: ONE 97 COMMUNICA,3062.0,116845.41,other_income
02 Nov 24,Debit,UPI/BILL,1655.0,115190.41,p2p_transfer
03 Nov 24,Credit,NEFT TRF: ONE 97 COMMUNICA,5715.0,120905.41,other_income
04 Nov 24,Credit,NEFT TRF: ONE 97 COMMUNICA,4539.0,125444.41,other_income
05 Nov 24,Credit,NEFT TRF: ONE 97 COMMUNICA,6198.0,131642.41,other_income
05 Nov 24,Debit,UPI/R THANGA,50000.0,81642.41,p2p_transfer
05 Nov 24,Debit,UPI/MUTHUMAN,4500.0,77142.41,p2p_transfer
05 Nov 24,Debit,UPI/K CHANDR,3400.0,73742.41,p2p_transfer
05 Nov 24,Debit,UPI/MS CHENN,39000.0,34742.41,p2p_transfer
05 Nov 24,Credit,NEFT TRF/BUNDL TECHNOLOGI,9299.52,44041.93,business_income
05 Nov 24,Debit,POS/EVP CINEMAS TIRUVALLUR,700.0,43341.93,entertainment_dining_out
05 Nov 24,Debit,POS/EVP CINEMAS TIRUVALLUR,420.0,42921.93,entertainment_dining_out
06 Nov 24,Credit,NEFT TRF/ONE 97 COMMUNICA,50.0,42971.93,other_income
06 Nov 24,Debit,ONL UPI/B KALLAV,20000.0,22971.93,p2p_transfer
06 Nov 24,Credit,NEFT TRF/ZOMATO LIMITED,10752.78,33724.71,other_income
07 Nov 24,Credit,NEFT TRF/ONE 97 COMMUNICA,2498.0,36222.71,other_income
07 Nov 24,Credit,NEFT TRF/BUNDL TECHNOLOGI,6056.91,42279.62,business_income
08 Nov 24,Credit,NEFT TRF/ONE 97 COMMUNICA,2545.0,44824.62,other_income
08 Nov 24,Debit,ONL UPI/SUN SEA,525.0,44299.62,p2p_transfer
09 Nov 24,Credit,NEFT TRF/ONE 97 COMMUNICA,8916.0,53215.62,other_income
10 Nov 24,Credit,NEFT TRF/ONE 97 COMMUNICA,10866.0,64081.62,other_income
10 Nov 24,Debit,ONL UPI/MR A SUN,49700.0,14381.62,p2p_transfer
11 Nov 24,Credit,NEFT TRF/ONE 97 COMMUNICA,7352.0,21733.62,other_income
12 Nov 24,Credit,NEFT TRF/ONE 97 COMMUNICA,2424.0,24157.62,other_income
12 Nov 24,Credit,NEFT TRF/BUNDL TECHNOLOGI,12667.4,36825.02,business_income
13 Nov 24,Credit,NEFT TRF/ONE 97 COMMUNICA,2611.0,39436.02,other_income
13 Nov 24,Credit,NEFT TRF/ZOMATO LIMITED,12801.69,52237.71,other_income
14 Nov 24,Credit,NEFT TRF/ONE 97 COMMUNICA,12618.0,64855.71,other_income
14 Nov 24,Debit,ATM WDL/VARDRAJPURAM II THIRUVALLUR,20000.0,44855.71,cash_withdrawal
14 Nov 24,Debit,ATM WDL/VARDRAJPURAM II THIRUVALLUR,20000.0,24855.71,cash_withdrawal
14 Nov 24,Debit,ATM WDL/VARDRAJPURAM II THIRUVALLUR,20000.0,4855.71,cash_withdrawal
14 Nov 24,Credit,NEFT TRF/BUNDL TECHNOLOGI,6697.06,11552.77,business_income
15 Nov 24,Credit,NEFT TRF/ONE 97 COMMUNICA,2187.0,13739.77,other_income
16 Nov 24,Credit,NEFT TRF/ONE 97 COMMUNICA,5392.97,19132.74,other_income
17 Nov 24,Credit,NEFT TRF/ONE 97 COMMUNICA,3499.0,22631.74,other_income
18 Nov 24,Credit,NEFT TRF/ONE 97 COMMUNICA,5658.63,28290.37,other_income
18 Nov 24,Debit,ONL UPI/MR AROKK,11200.0,17090.37,p2p_transfer
18 Nov 24,Debit,ONL UPI/PUSHPA D,8800.0,8290.37,p2p_transfer
18 Nov 24,Debit,ONL UPI/GAJASHIC,3000.0,5290.37,p2p_transfer
18 Nov 24,Debit,ONL UPI/MARIAPPA,4000.0,1290.37,p2p_transfer
19 Nov 24,Credit,NEFT TRF/ONE 97 COMMUNICA,2258.0,3548.37,other_income
19 Nov 24,Credit,NEFT TRF/BUNDL TECHNOLOGI,15792.8,19341.17,business_income
20 Nov 24,Credit,NEFT TRF/ONE 97 COMMUNICA,2071.43,21412.6,other_income
20 Nov 24,Credit,NEFT TRF/ZOMATO LIMITED,22895.93,44308.53,other_income
21 Nov 24,Credit,NEFT TRF/ONE 97 COMMUNICA,317.0,44625.53,other_income
21 Nov 24,Credit,NEFT TRF/BUNDL TECHNOLOGI,8463.47,53089.0,business_income
21 Nov 24,Debit,ONL UPI/WWWSEKAR,40000.0,13089.0,p2p_transfer
22 Nov 24,Credit,NEFT TRF/ONE 97 COMMUNICA,1164.56,14253.56,other_income
23 Nov 24,Credit,NEFT TRF/ONE 97 COMMUNICA,225.0,14478.56,other_income
24 Nov 24,Debit,MONTHLY MAINTENANCE CHARGES,531.0,13947.56,fees_charges
24 Nov 24,Credit,NEFT TRF/ONE 97 COMMUNICA,3308.0,17255.56,other_income
24 Nov 24,Debit,ONL UPI/ANNAIDIG,17000.0,255.56,p2p_transfer
25 Nov 24,Credit,NEFT TRF/ONE 97 COMMUNICA,4735.0,4990.56,other_income
26 Nov 24,Credit,NEFT TRF/ONE 97 COMMUNICA,182.0,5172.56,other_income
26 Nov 24,Credit,NEFT TRF/BUNDL TECHNOLOGI,11031.84,16204.4,business_income
27 Nov 24,Credit,NEFT TRF/ONE 97 COMMUNICA,380.0,16584.4,other_income
27 Nov 24,Credit,NEFT TRF/ZOMATO LIMITED,19297.09,35881.49,other_income
28 Nov 24,Credit,NEFT TRF/ONE 97 COMMUNICA,630.0,36511.49,other_income
28 Nov 24,Credit,NEFT TRF/BUNDL TECHNOLOGI,10183.5,46694.99,business_income
29 Nov 24,Credit,NEFT TRF/ONE 97 COMMUNICA,5783.0,52477.99,other_income
30 Nov 24,Credit,NEFT TRF/ONE 97 COMMUNICA,2831.72,55309.71,other_income
